N ./mg/NO.xpm
SO ./img/SO.xpm
WE ./img/WE.xpm
EA ./img/EA.xpm
D ./ig/D.xpm
SP ./img/sprite.xpm

F  50  0   ,  0

C 100   ,     150  ,    255  

         111111111111111111111111111
         10000000000000000000000011
         1011110001110000000000011111111111111111111
         10000000000000000000000000000000000000000001
1111111111011000000100000000000111111111111111111111
1000000000010011110001111111111
11110111111111    11111111
1  101111     
1111001 111111111111111 
1100000110101011100000111111
1D00000D00000000000N000000001
1120000111010101110101101000111
1111D111 1110101 101111010001
11111111 11111001001111111111
             1100011
              11111
