NO ./path_to_the_north_texture
SO ./path_to_the_south_texture
WE ./path_to_the_west_texture
EA ./path_to_the_east_texture

F220   ,     100  ,    0  



C 225 , 250,0

         11111111111 111111111111111
         10000000001 10000000000011
         1011000001110000000000011111111111111111111
         10010000000000000000000000000000000000000001
1111 11111011000001110000000000111111111111111111111
1001 10000110011110111111111111
1111 111111111    11111111
1  1 1111
1111101 111111111111111 
11000001101010111000N0111111
10000000000000001100000010001
10000000000000001101010010001
1100000111010101111101111000111
11110111 1110101 101111010001
11111111 1111111 111111111111
