NO ./img/NO.xpm
SO ./img/SO.xpm
WE ./img/WE.xpm
EA ./img/EA.xpm
D ./img/D.xpm

F220   ,     100  ,    0  

C 225 , 250,0

         111111111111111111111111111
         10000000000000000000000011
         1011110001110000000000011111111111111111111
         10000000000000000000000000000000000000000001
1111111111011000000100000000000111111111111111111111
1000000000010011110001111111111
11110111111111    11111111
1  1D1111     
1111001 111111111111111 
1100000110101011100000111111
1000E000000000000000000000001
1100000111010101110101101000111
11110111 1110101 101111010001
11111111 11111001001111111111
             1100011
              11111
